====================
====================
====================
====================
====================
=>.......===========
========.===========
=......=.===========
==.=.=...===========
=..=..=.============
=.===.=..===========
=..==G==.===========
====================
====================
====================
====================
====================
====================
====================
====================