====================
====================
====================
====================
====================
====================
====..........======
===..====.===...====
=======......==.====
=====...=.==....====
====.===.=<..=.=====
====......====.=====
====.====......=====
====.....======.====
===.====........====
===......==.===.====
=========...===....=
==========.=========
=G.........=========
====================