====================
=.................<=
=.==================
=..................=
=.==================
=..................=
=.==================
=..................=
=.==================
=..................=
==================.=
=..................=
==================.=
=..................=
==================.=
=..................=
==================.=
=..................=
==================G=
====================