====================
====================
====================
====================
=...G===============
=.==================
=.==.===============
=.==.===============
=.==.====.........==
=.==.============.==
=.==...........==.==
=.=======^====.==.==
=.==.==.==.=.=.==.==
=.==..............==
=.==.===============
=.==............====
=.=======.==========
=...........========
===========.========
====================