====================
==........==......==
==.======.==.====.==
==.=......==.=....==
==.======G==.====..=
==......====.....===
==.=====.....=======
==......====.....===
==.=====.....=======
==.=========.....===
==...........=======
==.=================
==...============.==
====..............==
=================.==
====..............==
====.===============
====...............=
==================v=
====================