====================
==========v=========
==========.=========
==========.....G====
==.........=========
==.=======.=.....===
==......==.=.===.===
==========.=.===.===
==========...===.===
================.===
==...............===
==.=================
==.........=====...=
=.========.=.....===
=..........=====.===
==========.......===
=======.=..=========
=======.==.=========
=======....=========
====================