====================
==...............<==
==========.=========
==................==
==========.=========
==========.=========
==................==
==========.=========
==========.=========
==................==
==========.=========
==========.=========
==................==
==========.=========
==========.=========
==................==
==========.=========
==G=======.======.==
==................==
====================